2 13 31
###############################
#      ** *    * 1 *  * * *  p#
# # # #*# # #*#*# # # #*#*#s# #
#   *     ***  *  1   * b * * #
# # # # # #*# # #*#*# # # # #*#
#s         f **  *  *         #
# # # # # # # # # #*# #*# # # #
#*  *      *  *      *  2     #
# # # # #*# # # #*#*# # # # # #
#*  2 **  *   b   *           #
# #*# # # # # # #*# # # # # # #
#x     1    *   *  *    1     #
###############################