3 13 31
###############################
#x     ** *    * 1 *  * * *  1#
# # # #*# # #*#*# # # #*#*#*# #
#1  *     ***  *  1   * b * * #
# # # # # #*# # #*#*# # # # #*#
#*    2    f **  *  *   1     #
# # # # # # # # # #*# #*# # # #
#*  *  2   *  *   1  *  2     #
# # # # #*# # # #*#*# # # # # #
#*  2 **  *   s   *  *  *  * *#
# #*# # # # # # #*# # #1# # # #
#x     1    *   *  * *  *  * p#
###############################